af - Afrikaans
ar - Arabic
az - Azerbaijani
ba - Bashkir
be - Belarusian
bg - Bulgarian
bn - Bengali
ca - Catalan
cs - Czech
cv - Chuvash
da - Danish
de - German
el - Greek
en - English
eo - Esperanto
es - Spanish
et - Estonian
eu - Basque
fa - Persian
fi - Finnish
fr - French
ga - Irish
gu - Gujarati
he - Hebrew
hi - Hindi
hr - Croatian
ht - Haitian
hu - Hungarian
hy - Armenian
is - Icelandic
it - Italian
ja - Japanese
ka - Georgian
kk - Kazakh
km - Central Khmer
ko - Korean
ku - Kurdish
ky - Kirghiz
lt - Lithuanian
lv - Latvian
ml - Malayalam
mn - Mongolian
ms - Malay
mt - Maltese
nb - Norwegian Bokmal
nl - Dutch
nn - Norwegian Nynorsk
pa - Panjabi
pl - Polish
ps - Pushto
pt - Portuguese
ro - Romanian
ru - Russian
sk - Slovakian
sl - Slovenian
so - Somali
sq - Albanian
sr - Serbian
sv - Swedish
ta - Tamil
te - Telugu
th - Thai
tr - Turkish
uk - Ukrainian
ur - Urdu
vi - Vietnamese
zh - Simplified Chinese
zh-TW - Traditional Chinese